1111111111
1EC0000001

1100C01C11
10C00P0101
1111111111