1111111111
1010000001
1E00C01C11
10C00P0101
1111111111