1111111111
1E00001001
1100000C01
10000P0001
1111111111