11111111111111111111
1100D00C000110D00101
1000000000D000000001
1E00C010000000000C11
10C000000P000D100001
11111111111111111111