11111111111111111111
1000000C000110000101
10100000000000000001
1E00C010000000000C11
10C000000P0000100001
11111111111111111111