1111111111
1EC00P0001
1111111111