111111111111
1E000000P001
100000000001
100001011101
10001000C101
1001C0011101
101000010C01
101111011101
100001000001
100C01000001
100000000001
111111111111