1111111111
1E00000001
1100001011
10000P0101
1111111111