1111111111
10C0000001
1100C01C11
10C00P0101
1111111111